original	actual	predicted	match?

與10月28日的那次不同，科密先生的這封信幾乎沒有被評論過。	與 10 月 28 日 的 那 次 不同 ， 科密 先生 的 這 封 信 幾乎 有 被 評論 過 。	" 雖然 美國 的 許多 數字化 轉型 都 是 史無前例 的 ， 但 權力 的 和平 轉移 卻 存在 先例 ， ” 奧巴馬 的 特別 助理 科瑞 · 舒爾曼 在 周 一 發布 的 博客 中 寫道 。	not a match

如果他的民主黨對手競選成功了，他保證她會“被調查很多年”。	如果 他 的 民主黨 對手 競選 成功 了 ， 他 保證 她 會 “ 被 調查 很多 年 ” 。		match

奧巴馬嘲笑他：“如果一個人管不好自己的推特賬號，那他也管不好核武器。”	奧巴馬 嘲笑 他 ： “ 如果 一 個 人 管 不 好 自己 的 推特 賬號 ， 那 他 也 管 不 好 核 武器 。 ”	對於 通過 社交 媒體 來 跟踪 國會山 任職 變遷 的 人 而 言 ， 這 次 與 以往 有 所 不同 。	not a match

根據流程，她將會在23點45分講話。	根據 流程 ， 她 將 會 在 23 點 45 分 講話 。		match

本週二，美國可能就會選出歷史上第一位女總統了。	本 週 二 ， 美國 可能 就 會 選出 歷史 上 第一 位 女 總統 了 。	但是 ， 他 在 過去 的 一 次 進行 移民 削減 相關 演說 的 休息 環節 ， 作 為 共和黨 候選人 ， 他 曾 宣稱 ， 作 為 總統 ， 基 於 政績 的 考量 他 將 允許 “ 超 大量 ” 合法 移民 。	not a match

另一方面，克林頓女士和這片大陸在過去二十年的關係還有很大改進的餘地。	另 一 方面 ， 克林頓 女士 和 這 片 大陸 在 過去 二十 年 的 關係 還 有 很大 改進 的 餘地 。		match

伊斯蘭正義與發展黨保守派把這次拒絕作為之前的疑問的證明。	伊斯蘭 正義 與 發展 黨 保守派 把 這 次 拒絕 作 為 之前 的 疑問 的 證明 。	“ 所以 我 不 想 給 你們 施加 哪怕 一丁點 的 壓力 ， 但 你們 肩負 的 是 共和國 的 命運 ， ” 奧巴馬 對 在 北卡羅來納 大學 運動場 上 的 群眾 說道 。	not a match

現在需要一個佔多數的第三方，特別是議員票(550張)中的367票內，至少要有330票才能提出公投。	現在 需要 一 個 佔 多數 的 第三 方 ， 特別 是 議員票 ( 550 張 ) 中 的 367 票 內 ， 至少 要 有 330 票 才 能 提出 公投 。		match

11月3日星期四，聖戈當（上加龍地區）市長決定暫停於2014年與政府簽訂的城市發展條約。	11 月 3 日 星期 四 ， 聖戈當 （ 上 加龍 地區 ） 市長 決定 暫停 於 2014 年 與 政府 簽訂 的 城市 發展 條約 。	希拉里 的 巨額 銀行 帳戶 使 政府 支出 的 突破 了 新上限 。	not a match

後者在監督共和黨的黨內初選，在那次初選中瑞啟達·達利對尼古拉斯·薩科齊表示了支持。	後者 在 監督 共和黨 的 黨內 初選 ， 在 那 次 初選 中 瑞啟達 · 達利 對 尼古拉斯 · 薩科齊 表示 了 支持 。		match

在這條信息裡，前司法部部長譴責布里斯·奧爾特弗是一個“法西斯分子”、“愚蠢內政部長”和一個”暴徒“。	在 這 條 信息 裡 ， 前司法部 部長 譴責 布里斯 · 奧爾特弗 是 一 個 “ 法西斯 分子 ” 、 “ 愚蠢 內政 部長 ” 和 一 個 ” 暴徒 “ 。	她 的 所言 所行 ， 簡直 令 人 難以置信 。	not a match

禁止在私人公司內表達宗教信仰的行為的限度是什麼？	禁止 在 私人 公司 內 表達 宗教 信仰 的 行為 的 限度 是 什麼 ？		match

即便工作環境中的大部分問題也可以通過無衝突的方法解決。	即便 工作 環境 中 的 大部分 問題 也 可以 通過 無 衝突 的 方法 解決 。	最高 限額 為 每人 5,000 美 元 。	not a match

工作人員可以把宗教相關的物品放在辦公桌上嗎？	工作 人員 可以 把 宗教 相關 的 物品 放 在 辦公桌 上 嗎 ？		match

法國工人力量總工會對手冊中沒有涵蓋他們的意見表示遺憾，吉拉德女士說：“根本沒有諮詢我們的意見。”	法國 工人 力量 總工會 對 手冊 中 有 涵蓋 他 的 意見 表示 遺憾 ， 吉拉德 女士 說 ： “ 根本 有 諮詢 我 的 意見 。 ”	在 十 月 初 ， 政權 轉移 團隊 在 同 一 場地 ， 會見 了 技術 團隊 的 說客 代表 ， 他 們 分別 來 自 Uber 公司 、 美國 電影 協會 、 美國 消費 科技 協會 及 其他 團體 。	not a match

這份指南存在問題，首先，因為它是在“緊急情況下”制定出來的。	這 份 指南 存在 問題 ， 首先 ， 因為 它 是 在 “ 緊急 情況 下 ” 制定 出來 的 。		match

這項條約將去客戶家的路途時間包含在工作時長內。	這 項 條約 將 去 客戶家 的 路途 時間 包含 在 工作 時長 內 。	這 次 集會 原本 定 在 幾 個 街區 之外 的 H 街上 華盛頓 的 私人 大都會 俱樂部 舉行 。	not a match

這兩個組織提交了上訴，但是在10月12日被最高法院駁回了。	這 兩 個 組織 提交 了 上訴 ， 但是 在 10 月 12 日 被 最高 法院 駁回 了 。		match

這樣做的目的是在無法計算實際路途時間的情況下，在將它從實際完成的工作時間中扣除後仍然把路途時間考慮進去。	這樣 做 的 目的 是 在 無法 計算 實際 路途 時間 的 情況 下 ， 在 將 它 從 實際 完成 的 工作 時間 中 扣除 後 仍然 把 路途 時間 考慮 進去 。	也許 著裝 要求 過 於 沉悶 。	not a match

第一小時的工作時間差不多是45分鐘左右。	第一 小時 的 工作 時間 差 不多 是 45 分鐘 左右 。		match

“ETA要來了，”法國代表透露。	“ ETA 要 來 了 ， ” 法國 代表 透露 。	而 不 是 把 科學 研究 方法 作 為 一 個 獨立 的 章節 來 教授 ， 例如 ， 學生 通過 實際 運用 來 學習 科學 課程 的 內容 。	not a match

他也表示，“這樣一份文件的存在可能會帶來讓人難以接受的後果。”	他 也 表示 ， “ 這樣 一 份 文件 的 存在 可能 會 帶來 讓 人 難 以 接受 的 後果 。 ”		match

對議案提出了建議，同時對數碼技術提出了問題的法國數字委員會，也可以對其進行詳細檢查。	對 議案 提出 了 建議 ， 同時 對 數碼 技術 提出 了 問題 的 法國 數字 委員會 ， 也 可以 對 其 進行 詳細 檢查 。	他 們 的 成績 屬 於 4 年級 的 全國 平均 水平 ， 且 優 於 8 年級 的 全國 平均 水平 。	not a match

根據費加羅報的說法，政府的計劃能夠省出4200萬歐元，其中1550萬歐元可以供安保使用。	根據 費加羅報 的 說法 ， 政府 的 計劃 能夠 省出 4200萬 歐 元 ， 其中 1550萬 歐 元 可以 供 安保 使用 。		match

法國名聲不太好。	法國 名聲 不 太好 。	相比 之下 ， 於 2004 年 開業 的 諾瑪 城際 地鐵站 修建 所 耗 成本 為 103.7億 美 元 。	not a match

蒂娜·安塞密爾於1927年3月25日出生於威尼托自由堡；她在一個反法西斯的天主教家庭中長大，她的家庭受社會主義軍人父親被迫害的經歷的影響。	蒂娜 · 安塞密爾 於 1927 年 3 月 25 日 出生 於 威尼托 自由堡 ； 她 在 一 個 反 法西斯 的 天主教 家庭 中 長大 ， 她 的 家庭 受 社會 主義 軍人 父親 被 迫害 的 經歷 的 影響 。		match

一直與天主教聯盟關係密切的蒂娜·安賽密爾尤其關注教師和紡織業工人的權利。	一直 與 天主教 聯盟 關係 密切 的 蒂娜 · 安賽密爾 尤其 關注 教師 和 紡織業 工人 的 權利 。	” 我 們 面臨 很多 競爭 ， 而 我 們 認 為 政權 轉移 能 對 此 局面 有 所 幫助 ， ” 喬治城 商業 改善會 主席 喬 · 斯頓雷 說道 。	not a match

難以想像意大利擁有的地鐵里程竟然少於馬德里。	難 以 想像 意大利 擁有 的 地鐵 里程 竟然 少 於 馬德里 。		match

特別要強調的是，我們絕對無法繼續與完全反對意大利的人合作。	特別 要 強調 的 是 ， 我 絕對 無法 繼續 與 完全 反對 意大利 的 人 合作 。	根據 可行性 研究 估計 ， 乘客 乘坐 纜車 穿越 波托馬克河 需時 約 四 分鐘 。	not a match

我們要評估是否需要以及如何進入下一部分。	我 要 評估 是 需要 以及 如何 進入 下 一 部分 。		match

大熱的歌曲是由Sheppard演唱的《Geronimo》。	大熱 的 歌曲 是 由 Sheppard 演唱 的 《 Geronimo 》 。	一 位 目擊者 告訴 警方 ， 被 害人 曾 在 四 月 襲擊 過 嫌疑人 。	not a match

政府會為老年人提供500歐元，這500歐元需要在2017年12月31日之前花完。	政府 會 為 老年人 提供 500 歐 元 ， 這 500 歐 元 需要 在 2017 年 12 月 31 日 之前 花完 。		match

一張抵價券會被生成，它可以存在智能手機里或在櫃檯出示。	一 張 抵價券 會 被 生成 ， 它 可以 存在 智能 手機 里 或 在 櫃檯 出示 。	遊戲 與 我 們 的 日常 生活 有 相似 之 處 。	not a match

從1月1日開始，汽油和柴油價格會有所上漲。	從 1 月 1 日 開始 ， 汽油 和 柴油 價格 會 有 所 上漲 。		match

CGI Mestre在通知中表明，至少在2017年以前，增值稅不會上升。	CGI Mestre 在 通知 中 表明 ， 至少 在 2017 年 以前 ， 增值稅 會 上升 。	這 個 比例 多 年 來 一直 在 穩步 上升 —— 根據 人口 普查局 數據 顯示 ， 1996 年 選舉日 之前 所 接收 的 投票 只有 總投票額 的 11% ， 今年 這 個 數字 可能 再次 激增 。	not a match

在兩個情況下都屬於歐盟首位水平。	在 兩 個 情況 下 都 屬 於 歐盟 首位 水平 。		match

最新的數據來源於去年10月24日，其中講到，柴油價格為1335歐元每升，歐元區平均價格為1165歐元每升。	最新 的 數據 來源 於 去年 10 月 24 日 ， 其中 講到 ， 柴油 價格 為 1335 歐 元 每升 ， 歐元區 平均 價格 為 1165 歐 元 每升 。	現在 ， Khanzir 可能 是 一 隻 寂寞 的 豬 ， 但 他 並 不 是 一直 都 孤獨 。	not a match

花費為1365歐元每升，這個價格大幅超過了使用單一貨幣國家的平均價格。	花費 為 1365 歐 元 每升 ， 這 個 價格 大幅 超過 了 使用 單一 貨幣 國家 的 平均 價格 。		match

科朵拉·帕塞拉撤回了提供給西雅那銀行的報價，原因是“銀行對我們展現的怠慢態度”。	科朵拉 · 帕塞拉 撤回 了 提供 給 西雅那 銀行 的 報價 ， 原因 是 “ 銀行 對 我 展現 的 怠慢 態度 ” 。	“ 我 們 已經 要求 其他 國家 用 不同 種群 的 動物 （ 包括 豬 ） 來 幫助 我 們 擴充 動物園 ， ” 薩奇布 說 。	not a match

正如指出的那樣，這個決定是歐洲央行的權力，如果銀行從自己的角度考慮而排除了其他的選項的可能性，這樣是不合適的。	正 如 指出 的 那樣 ， 這 個 決定 是 歐洲 央行 的 權力 ， 如果 銀行 從 自己 的 角度 考慮 而 排除 了 其他 的 選項 的 可能性 ， 這樣 是 不 合適 的 。		match

這是在前部長決定退黨之後寫在一張給西雅那銀行的通知上的信息。	這 是 在 前部長 決定 退黨 之後 寫 在 一 張 給 西雅那 銀行 的 通知 上 的 信息 。	潘 沃爾卡 先生 說 ， 曾經 有 一 段 時刻 ， 他 們 覺得 自己 應該 離開 那 幢 大樓 。	not a match

這需要評估。	這 需要 評估 。		match

在課上，國際社會科學自由大學的學生被告知了一場在羅馬舉辦的會議。	在 課上 ， 國際 社會 科學 自由 大學 的 學生 被 告知 了 一 場 在 羅馬 舉辦 的 會議 。	她 還 被 指控 試圖 殺死 她 兩 歲 大 的 女兒 。	not a match

今天上午，教皇方濟各在聖瑪爾塔會見了馬克·扎克伯格及其妻子。	今天 上午 ， 教皇 方濟各 在 聖瑪爾塔 會見 了 馬克 · 扎克伯格 及 其 妻子 。		match

羅馬第三大學的四名學生髮明出了一種通過預測司機行動來“讀心”的摩托車頭盔。	羅馬 第三 大學 的 四 名 學生 髮明 出 了 一 種 通過 預測 司機 行動 來 “ 讀心 ” 的 摩托車 頭盔 。	警方 表示 ， 她 把 兒子 安德烈 的 臉 按進 客廳 的 床墊 裡 殺死 了 他 ， 之後 又 試圖 用 同樣 的 方式 殺死 女兒 安吉爾 。	not a match

在安全措施下，其中一個研究的實例也製造了一個和瓦倫蒂諾·羅西競爭的擬人機器人。	在 安全 措施 下 ， 其中 一 個 研究 的 實例 也 製造 了 一 個 和 瓦倫蒂諾 · 羅西 競爭 的 擬人 機器人 。		match

作為回報，優步公司會獲得10億美元的投資，同時會獲得中國公司董事會的一席。	作 為 回報 ， 優步 公司 會 獲得 10億 美 元 的 投資 ， 同時 會 獲得 中國 公司 董事會 的 一 席 。	不管 哪 種 情況 ， 我 都 要 坐牢 ， 希望 這麼 做 是 值得 的 。	not a match

前所未有的是，越來越多的科技公司能夠在華爾街上有一席之地了，數量甚至比在矽谷的還要多。	前所未有 的 是 ， 越來越 多 的 科技 公司 能夠 在 華爾街 上 有 一 席 之 地 了 ， 數量 甚至 比 在 矽谷 的 還 要 多 。		match

亞馬遜，超過了美孚公司，成為了第四家擁有最大市場佔有量的美國公司。	亞馬遜 ， 超過 了 美孚 公司 ， 成 為 了 第四 家 擁有 最大 市場 佔有量 的 美國 公司 。	其中 一 個 雅茲迪 女人 開始 哭泣 ， 隨後 她 的 一 個 朋友 也 開始 哭泣 。	not a match

Spotify，特斯拉，優步以及快拍等公司的領導人在山景城峰會以外還會參加一個私人活動。	Spotify ， 特斯拉 ， 優步 以及 快拍 等 公司 的 領導人 在 山景城 峰會 以外 還 會 參加 一 個 私人 活動 。		match

馬德里自治區總統Cristina Cifuentes代表了最保守的一派，而黨派領導人，比如副部長Javier Maroto則代表了最激進的一派。	馬德里 自治區 總統 Cristina Cifuentes 代表 了 最 保守 的 一 派 ， 而 黨派 領導人 ， 比如 副部長 Javier Maroto 則 代表 了 最 激進 的 一 派 。	奧斯本 先生 在 七 月 被 解僱 後 ， 與 一 個 美國 音箱 代理 機構 簽訂 了 協議 。	not a match

Durán擔任發言人，Ángel Pintado擔任財務長。	Durán 擔任 發言人 ， Ángel Pintado 擔任 財務長 。		match

在過去六年間失業率頭一次降到了20%以下，和去年相比，已經有60萬人找到了新工作。	在 過去 六 年 間 失業率 頭 一 次 降到 了 20% 以下 ， 和 去年 相比 ， 已經 有 60萬 人 找到 了 新工作 。	邁克爾 · 法倫 說 ， 切斷 第一 根 鋼材 的 那 一 天 ， 保證 了 新投資 ， 和 上百 個 技術 工作 的 安全 ， 該 效應 可 持續 到 2035 年 。	not a match

但是，它的管理一直飽受批評。	但是 ， 它 的 管理 一直 飽受 批評 。		match

聯盟最近鬥志昂揚，並且在好幾個場合下要求廢除Fátima Báñez引以為豪的立法決定。	聯盟 最近 鬥志 昂揚 ， 並且 在 好幾 個 場合 下 要求 廢除 Fátima Báñez 為 的 立法 決定 。	為了 保全 克萊德 造船 產業 ， 新皇家 海軍 在 2014 年 蘇格蘭 獨立 公投 之前 許下 下達 訂單 的 承諾 。	not a match

這個部門現在面臨新的挑戰。	這 個 部門 現在 面臨 新 的 挑戰 。		match

另外，政府還需要對付另一個“燙手山芋”。	另外 ， 政府 還 需要 對付 另 一 個 “ 燙手 山芋 ” 。	顯而易見 的 是 ， 名人 的 名字 最開始 是 相當 罕見 的 。	not a match

國防部長允許她暫時繼續擔任秘書長。	國防 部長 允許 她 暫時 繼續 擔任 秘書長 。		match

消息來源表示這是“100%屬於科斯佩達爾”的。	消息 來源 表示 這 是 “ 100% 屬 於 科斯佩達爾 ” 的 。	而 直至 2007 年 ， 觀 其 （ 也許 還 有 奈特利 的 ） 常見 程度 ， 其 是 前 50 名 常用 名字 之 一 ， 名 為 凱拉 的 嬰兒 是 名 為 奇爾拉 的 嬰兒 的 三 倍 多 。	not a match

除了他們以外，黨內不是所有人都能理解昨天總統想要傳達給他們的信息。	除 了 他 以外 ， 黨內 是 所有 人 都 能 理解 昨天 總統 想 要 傳達 給 他 的 信息 。		match

Claret伯爵是政府中唯一一位有貴族頭銜的人。	Claret 伯爵 是 政府 中 唯一 一 位 有 貴族 頭銜 的 人 。	這 家 韓國 公司 最初 以 為 電池 故障 是 罪魁 禍首 ， 因而 替代 自己 的 組件 改用 第三 方 電源 單元 。	not a match

和許多社會主義者一樣，Pedro Sánchez在Évole項目中表示西班牙是萬民之邦。	和 許多 社會 主義 者 一樣 ， Pedro Sánchez 在 Évole 項目 中 表示 西班牙 是 萬民 之 邦 。		match

那些歷史權力派的黨派又怎麼樣呢？	那些 歷史 權力派 的 黨派 又 怎麼 樣 呢 ？	一些 分析家 認 為 華為 最 有 可能 從 三星 的 挫折 中 受益 。	not a match

費德里克·費里尼曾經說過：“小丑之於人性就如同影子之於常人。”	費德里克 · 費里尼 曾經 說 過 ： “ 小丑 之於 人性 就 如同 影子 之於 常人 。 ”		match

他獨自一人面對觀眾，最終，他要拿出自己的最大本事來逗他們笑。	他 獨自 一 人 面對 觀眾 ， 最終 ， 他 要 拿出 自己 的 最大 本事 來 逗 他 笑 。	Mate   9 手機 缺少 一 個 像 谷歌 助手 或 蘋果 的 Siri 那樣 的 人工 智能 界面 。	not a match

在戰爭片、西部片和印第安電影中，戰場、打鬥和打人的場景總是不大切合實際。	在 戰爭片 、 西部片 和 印第安 電影 中 ， 戰場 、 打鬥 和 打人 的 場景 總 是 不大 切合 實際 。		match

強調、諷刺、暗諷以及其他巧妙的口頭修辭手法十分適合議會演講，但是互相調笑和表演鬧劇就不大適合了。	強調 、 諷刺 、 暗諷 以及 其他 巧妙 的 口頭 修辭 手法 十分 適合 議會 演講 ， 但是 互相 調笑 和 表演 鬧劇 就 不大 適合 了 。	但 有 旅行 專家 警告 說 ， 飛機 飛行 時 配置 的 空中 網絡 往往 不 可靠 ， 而且 不 太 可能 影響 旅客 對 航空 公司 的 選擇 。	not a match

他堅信那些等我們的人並不是真的在等我們。	他 堅信 那些 等 我 的 人 並 是 真的 在 等 我 。		match

可能這就是為什麼當飛逝的時間揭示了他的成果，揭示了他對結合水的秘密的發現時，洶湧的眼淚模糊了他的眼睛。	可能 這 是 為 什麼 當 飛逝 的 時間 揭示 了 他 的 成果 ， 揭示 了 他 對 結合水 的 秘密 的 發現 時 ， 洶湧 的 眼淚 模糊 了 他 的 眼睛 。	但 可能 英國 航空 和 國際 航空 集團 已經 破解 了 它 ， 並 可 提供 一些 大致 上 可靠 的 信息 。	not a match

他們是美麗而且充滿希望的新一代，所以必須要用開放的心態和清醒的頭腦來對待。	他 是 美麗 而且 充滿 希望 的 新一 代 ， 所以 必須 要 用 開放 的 心態 和 清醒 的 頭腦 來 對待 。		match

因此，特朗普並不擔心拉丁美裔的投票會在全國范圍內造成影響。	因 此 ， 特朗普 並 不 擔心 拉丁 美裔 的 投票 會 在 全國 范圍 內 造成 影響 。	該 公司 向 BBC 表示 ， 是 否 向 乘客 收取 使用費 ， 應該 由 航空 公司 自行 決定 。	not a match

初期的投票顯示這次拉丁美裔美國人投票人數有所增加，但會不會產生影響還未可知。	初期 的 投票 顯示 這 次 拉丁 美裔 美國人 投票 人數 有 所 增加 ， 但 會 產生 影響 還 未 可 知 。		match

反對派告訴《西班牙世界報》：“一定會有抗議和其他活動的，這些都已經計劃好了。”	反對派 告訴 《 西班牙 世界報 》 ： “ 一定 會 有 抗議 和 其他 活動 的 ， 這些 都 已經 計劃 好 了 。 ”	大 多數 人 會 認 為 機場 Wi-Fi 比 能 在 飛機 上 發電 子 郵件 這 件 事 更加 有用 。	not a match

許多FSLN的支持者已經在維多利亞廣場上慶祝他們的勝利了。	許多 FSLN 的 支持者 已經 在 維多利亞 廣場 上 慶祝 他 的 勝利 了 。		match

由於英國退歐決定之後迴避和不公開回應媒體，特蕾莎·梅飽受批評。	由於 英國 退 歐 決定 之後 迴避 和 不 公開 回應 媒體 ， 特蕾莎 · 梅 飽受 批評 。	它 有時 候 看 起來 像 超能力 。	not a match

為了娛樂大眾，在1925年建了一個露天劇場在聖·邁克爾教堂前的大台階上，此劇場現在仍在吸引各種各樣的觀眾。	為了 娛樂 大眾 ， 在 1925 年 建 了 一 個 露天 劇場 在 聖 · 邁克爾 教堂 前 的 大台階 上 ， 此 劇場 現在 仍 在 吸引 各種 各樣 的 觀眾 。		match

節日慶典於1955年4月30日舉行。	節日 慶典 於 1955 年 4 月 30 日 舉行 。	該 方案 通過 贊助 和 廣告 來 盈利 。	not a match

1882年，一個裝有34個消防報警信號的電報系統投入使用。	1882 年 ， 一 個 裝有 34 個 消防 報警 信號 的 電報 系統 投入 使用 。		match

1992年，該區以前木偶劇場的場地剩了下來，現已被演員和員工接管。	1992 年 ， 該區 以前 木偶 劇場 的 場地 剩 了 下來 ， 現 已 被 演員 和 員工 接管 。	這 項 為 期 10 週 的 課程 已經 被 英國 情報 機構 GCHQ “ 認證 ” 了 。	not a match

這跟在第二次世界大戰戰末沒有被摧毀的市中心少數建築之一有關。	這 跟 在 第二 次 世界 大戰 戰末 有 被 摧毀 的 市 中心 少數 建築 之 一 有關 。		match

1832年，以前的修道院被符騰堡賣給了製造商喬格·萊辛巴哈（Georg Reichenbach），要求把那兒建成一個棉花廠。	1832 年 ， 以前 的 修道院 被 符騰堡 賣給 了 製造商 喬格 · 萊辛巴哈 （ Georg Reichenbach ） ， 要求 把 那兒 建成 一 個 棉花廠 。	但是 ， 一些 安全 專家 對 該 課程 的 設立 及 其 背後 的 意圖 提出 了 質疑 。	not a match

從20世紀60年代初就定居下來的伊斯蘭市民主要來自土耳其。	從 20 世紀 60 年代 初 就 定居 下來 的 伊斯蘭 市民 主要 來 自 土耳其 。		match

在他們之間的是聖彼得聖保羅修道院教堂的舊迴廊。	在 他 之間 的 是 聖 彼得 聖 保羅 修道院 教堂 的 舊迴廊 。	此前 ， 只有 博客 撰稿人 見 過 這些 噴氣機 。	not a match

德國Obermarsberg具有歷史性的市政廳建於13世紀，並在三十年戰爭後進行了修補。	德國 Obermarsberg 具有 歷史性 的 市政廳 建 於 13 世紀 ， 並 在 三十 年 戰爭 後 進行 了 修補 。		match

對於離開這個地方的原因，大家有很多不同的理解。	對於 離開 這 個 地方 的 原因 ， 大家 有 很多 不同 的 理解 。	通常 ， 中國 將 在 本週 內 展示 許多 其他 軍事 硬件 ， 如 殲擊機 和 海上 飛機 等 。	not a match

超過四千米長的金門公園裡有植物園、天文館、日本花園和水族館。	超過 四千 米 長 的 金門 公園 裡 有 植物園 、 天文館 、 日本 花園 和 水族館 。		match

它是一個供當地舊金山人休息和放鬆的地方。	它 是 一 個 供 當地 舊金山人 休息 和 放鬆 的 地方 。	由於 中國 將 在 未來 十 年 內 成 為 全球 最大 的 航空 市場 ， 此次 展會 將 是 北京 在 民 用 航空 以及 國防 方面 展示 野心 的 機會 。	not a match

舊金山芳草地公園（The Yerba Buena Garden）建於20世紀90年代初期，位於莫斯克尼北部會議中心的頂部。	舊金山 芳草地 公園 （ The Yerba Buena Garden ） 建 於 20 世紀 90 年代 初期 ， 位 於 莫斯克尼 北部 會議 中心 的 頂部 。		match

裡面有馬丁·路德·金（Martin Luther King, Jr.）的紀念碑。	裡面 有 馬丁 · 路德 · 金 （ Martin Luther King, Jr. ） 的 紀念碑 。	” 不幸 的 是 再次 證明 了 ， 少數 人 替 多數 人 毀壞 了 它 ” 黑客 論壇 的 創始人 傑西卡 · 拉布羅卡 在 解釋 其 關閉 原因 的 一 則 消息 中 寫道 。	not a match

從20世紀60年代起，該城市的經濟就一直急劇下滑。	從 20 世紀 60 年代 起 ， 該 城市 的 經濟 就 一直 急劇 下滑 。		match

2010年大選中，工黨能贏得了所有七個選區的選票。	2010 年 大選 中 ， 工黨 能 贏得 了 所有 七 個 選區 的 選票 。	" 最新 的 事件 " 很 可能 是 指 10 月 21 日 的 攻擊 ， 該 攻擊 令 熱門 網站 例如 Reddit ， Twitter 和 Spotify ， 以及 很多 其他 網站 都 掛 了 。	not a match

人們對事件的發生時間及發展順序進行了熱烈的討論。	人 對 事件 的 發生 時間 及 發展 順序 進行 了 熱烈 的 討論 。		match

2012年4月，土耳其總理埃爾多安宣布其政府計劃藉由建立伊斯坦堡運河來解放與之平行的博斯普魯斯海峽。	2012 年 4 月 ， 土耳其 總理 埃爾多安 宣布 其 政府 計劃 藉由 建立 伊斯坦堡 運河 來 解放 與 之 平行 的 博斯普魯斯 海峽 。	分析 表明 ， 已經 使用 了 大量 的 歷史 數據 ， 造成 中斷 。	not a match

奧斯曼人想要阻礙穀物被進一步轉運，因為他們對穀物有很大的需求。	奧斯曼人 想 要 阻礙 穀物 被 進 一 步 轉運 ， 因為 他 對 穀物 有 很大 的 需求 。		match

奧斯曼帝國和俄國想在黑海保留他們的戰艦，但這一想法遭到拒絕。	奧斯曼 帝國 和 俄國 想 在 黑海 保留 他 的 戰艦 ， 但 這 一 想法 遭到 拒絕 。	聯合國 回顧 國家 削減 碳 計劃 時 說 ， 他 們 非常 難 以 實現 保持 全球 氣溫 上升 2C 下 所需 要 的 水平 。	not a match

在其範圍內，它屬於當時影響最深遠的文化之一，其中，很多遺址都很有名。	在 其 範圍 內 ， 它 屬 於 當時 影響 最 深遠 的 文化 之 一 ， 其中 ， 很多 遺址 都 很 有名 。		match

就像大多數南歐的地點一樣，該研究可追溯到早至公元前5世紀。	就 像 大 多數 南 歐 的 地點 一樣 ， 該 研究 可 追溯 到 早 至 公元 前 5 世紀 。	許多 科學家 說 ， 目前 需要 去除 空氣 中 的 碳 的 技術 來 滿足 巴黎 的 目標 。	not a match

紅銅時代最有名的人可能是生活在公元前3300年的木乃伊冰人奧茲（Ötzi）。	紅銅 時代 最 有名 的 人 可能 是 生活 在 公元 前 3300 年 的 木乃伊 冰人 奧茲 （ Ötzi ） 。		match

他們當時原本在山上。	他 當時 原本 在 山上 。	聯合國 環境 規劃署 負責人 埃里克 · 索爾海姆 說 ， 我 們 正 朝著 正確 的 方向 前進 ： 巴黎 協議 提及 將 減緩 氣候 變化 ， 近期 的 基加利 修正案 也 提及 減少 氫氟碳化合物 排放 。	not a match

另外，從技術上說，鍍銅這一過程值得關注。	另外 ， 從 技術 上 說 ， 鍍銅 這 一 過程 值得 關注 。		match

農村革命的嚴重性及出現使凡爾賽法庭和國民議會感到驚恐。	農村 革命 的 嚴重性 及 出現 使 凡爾賽 法庭 和 國民 議會 感到 驚恐 。	這 方面 的 投資 在 2015 年 增長 了 6% ， 至 2210億 美 元 。	not a match

該事件發生在巴黎，它使本來就已經因為麵包價格持續高漲及缺少供應而感到失望的人們更加沮喪。	該 事件 發生 在 巴黎 ， 它 使 本來 就 已經 因為 麵包 價格 持續 高漲 及 缺少 供應 而 感到 失望 的 人 更加 沮喪 。		match

國王在逃跑時不夠謹慎，在停留時多次被認出來。	國王 在 逃跑 時 夠 謹慎 ， 在 停留 時 多 次 被 認 出來 。	他 們 得到 了 巴黎 協定 這 件 事 值得 慶賀 ， 但 目前 他 們 的 貢獻 從未 達到 了 1.5 度 的 目標 。	not a match

讚美詩獲得一致好評，觀眾要求返場。	讚美詩 獲得 一致 好評 ， 觀眾 要求 返場 。		match

我宣布第一屆國際奧林匹克運動會到此結束。	我 宣布 第一 屆 國際 奧林匹克 運動會 到此 結束 。	它 於 4 至 6 月 在 墨西哥 海岸 舉行 。	not a match

第一次世界大戰帶來了殖民政治的轉變和新發展。	第一 次 世界 大戰 帶來 了 殖民 政治 的 轉變 和 新發展 。		match

英國的工業革命比其他任何國家的工業革命都早。	英國 的 工業 革命 比 其他 任何 國家 的 工業 革命 都 早 。	這 將 增加 新限制 在 曾經 發生 在 地球 上 並 毀滅 了 許多 物種 （ 不僅 是 恐龍 ） 自然 環境 變化 上 。	not a match

蘇伊士運河危機顯示了舊殖民地力量如大英帝國和法國在這個不斷變化的世界裡的局限。	蘇伊士 運河 危機 顯示 了 舊殖民地 力量 如 大英 帝國 和 法國 在 這 個 不斷 變化 的 世界 裡 的 局限 。		match

在1933年國社黨的掌權後，各處都想贏回舊殖民地。	在 1933 年 國社黨 的 掌權 後 ， 各處 都 想 贏回 舊殖民地 。	揭露 這 是 個 隕石 材料 的 ， 很 可能 是 其中 高含量 的 銥 元素 。	not a match

在1917年俄國革命後，一些國家，如芬蘭、波蘭及波羅的海諸國，贏得了獨立。	在 1917 年 俄國 革命 後 ， 一些 國家 ， 如 芬蘭 、 波蘭 及 波羅的海 諸國 ， 贏得 了 獨立 。		match

他對匈牙利施壓的最後一個方法是實行自由大選。	他 對 匈牙利 施壓 的 最後 一 個 方法 是 實行 自由 大選 。	超過 70％ 從 地球 種子 長成 的 植物 在 17 天 之後 存活 - 僅僅 略 高 於 從 太空 種子 長成 的 植物 - 剛剛 超過 66％ 。	not a match

在1867年簽訂奧匈妥協協約後，奧地利皇帝兼匈牙利國王弗朗茨·約瑟夫一世非常注重在兩國平等實施君主制。	在 1867 年 簽訂 奧 匈 妥協 協約 後 ， 奧地利 皇帝 兼 匈牙利 國王 弗朗茨 · 約瑟夫 一世 非常 注重 在 兩 國 平等 實施 君主制 。		match

迪希邦登堡修道院被解散，後因宗教改革而變為廢墟。	迪希邦登堡 修道院 被 解散 ， 後 因 宗教 改革 而 變 為 廢墟 。	從 該 實驗 的 結果 提供 了 進 一 步 的 支持 ， 火箭 上 的 種子 可以 存儲 在 國際 空間站 上 並 飛行 六 個 月 ， 而 不 會 對 它 們 在 地球 上 發芽 生長 的 能力 產生 任何 顯著 影響 。	not a match

如今，可在那裡看到廣闊的遺跡。	如今 ， 可 在 那裡 看到 廣闊 的 遺跡 。		match

魯帕斯堡（Rupertsberg）修道院於1632年在三十年戰爭中被瑞典軍隊摧毀。	魯帕斯堡 （ Rupertsberg ） 修道院 於 1632 年 在 三十 年 戰爭 中 被 瑞典 軍隊 摧毀 。	RHS 收集 了 在 實驗 中 的 學生 和 老師們 發來 的 意見 。	not a match

流離失所的修女們搬回了艾賓根（Eibingen）修道院。	流離失所 的 修女們 搬回 了 艾賓根 （ Eibingen ） 修道院 。		match

後來對廢墟進行了重建。	後來 對 廢墟 進行 了 重建 。	她 說 ， 購買 和 穿戴 別人 “ 身體 部位 ” 的 想法 仍舊 讓 人 感覺 到 ‘ 噁心 ’ 。	not a match

成功後，他跟德國電信簽了一份合同，跟女朋友一起住在南拜登的梅爾丁根，一直住到2002年。	成功 後 ， 他 跟 德國 電信 簽 了 一 份 合同 ， 跟 女 朋友 一起 住 在 南 拜登 的 梅爾丁根 ， 一直 住到 2002 年 。		match

2004年雅典奧林匹克運動會街道賽冠軍烏爾里希仍在追逐贏得第二塊金牌的目標。	2004 年 雅典 奧林匹克 運動會 街道賽 冠軍 烏爾里希 仍 在 追逐 贏得 第二 塊 金牌 的 目標 。	在 中國 ， 毛髮 通常 是 放 在 化學浴 徹 中 底 去除 角質層 ， 塔爾羅 解釋 說 。	not a match

審查處理了所有令人不快的言論；但也讓公共生活變得乎無法參與。	審查 處理 了 所有 令 人 不快 的 言論 ； 但 也 讓 公共 生活 變得 乎 無法 參與 。		match

衣服上的血跡與謀殺案案發當天報導上的描述一樣。	衣服 上 的 血跡 與 謀殺案 案發 當天 報導 上 的 描述 一樣 。	縱觀 歷史 ， 國際 頭髮 市場 上 一直 有 著 政治 層面 的 意義 ， Tarlo 說 。	not a match

科隆和不來梅分別授予了韋斯（Weiss）文學獎的殊榮。	科隆 和 不來梅 分別 授予 了 韋斯 （ Weiss ） 文學獎 的 殊榮 。		match

不論是私下還是公開，施普林格一直積極尋求與猶太人和解並為此去過很多次以色列。	不論 是 私下 還是 公開 ， 施普林格 一直 積極 尋求 與 猶太人 和解 並 為 此 去 過 很多 次 以色列 。	帖子 上 寫 著 ， 我 們 今晚 將 使用 高激光束 進行 處罰 。	not a match

小木屋被完全燒毀。	小木屋 被 完全 燒毀 。		match

第二年，也就是1977年，由於他的媒體對美國的態度很友好，他收到了美國友誼榮譽勳章。	第二 年 ， 也 是 1977 年 ， 由於 他 的 媒體 對 美國 的 態度 很 友好 ， 他 收到 了 美國 友誼 榮譽 勳章 。	深圳市 交警 以前 曾 選用 非常 規 處罰 。	not a match

城市中大部分的社會住房位於Viguier區和La Conte區內，因為這兩個區的人口主要由移民或來自移民國家的人組成。	城市 中 大部分 的 社會 住房 位 於 Viguier區 和 La Conte 區 內 ， 因為 這 兩 個 區 的 人口 主要 由 移民 或 來 自 移民 國家 的 人 組成 。		match

卡爾卡鬆的歷史與其城堡要塞直接相關。	卡爾卡鬆 的 歷史 與 其 城堡 要塞 直接 相關 。	這些 人 是 誰 ？	not a match

在21世界初，每10萬居住人口中有5名醫生。	在 21 世界 初 ， 每 10萬 居住 人口 中 有 5 名 醫生 。		match

國際特赦組織表示，根據2008年以來的報紙文章顯示，有50個人由於被指控會巫術而被殺害。	國際 特赦 組織 表示 ， 根據 2008 年 以來 的 報紙 文章 顯示 ， 有 50 個 人 由於 被 指控 會 巫術 而 被 殺害 。	今年 有關 民主黨 的 爭論 ， 一直 圍繞 著 白人 男性 身分 。	not a match

馮·別林斯高晉於1820年1月27日發現了南極大陸，比布蘭斯菲爾德發現大陸早了3天，比1820年11月發現大陸的帕爾馬早了10個月。	馮 · 別林斯高晉 於 1820 年 1 月 27 日 發現 了 南極 大陸 ， 比 布蘭斯菲爾德 發現 大陸 早 了 3 天 ， 比 1820 年 11 月 發現 大陸 的 帕爾馬 早 了 10 個 月 。		match

在1914年的長途征程中，船長歐內斯特·沙克爾頓爵士及其船員共28人乘坐英國船隻“堅毅號”準備橫穿南極。	在 1914 年 的 長途 征程 中 ， 船長 歐內斯特 · 沙克爾頓 爵士 及 其 船員 共 28 人 乘坐 英國 船隻 “ 堅毅 號 ” 準備 橫穿 南極 。	我 事後 問 她 是 不 是 明白 為 什麼 人 們 會 投票 給 特朗普 。	not a match

這次擬定為羅馬法、羅馬共和國的建立以及習慣法建立了基礎。	這 次 擬定 為 羅馬 法 、 羅馬 共和國 的 建立 以及 習慣法 建立 了 基礎 。		match

但是，為了參加南意大利的商業會務，皮洛士不得不離開了西西里。	但是 ， 為了 參加 南 意大利 的 商業 會務 ， 皮洛士 得 不 離開 了 西西里 。	不 是 每個 人 都 可以 超越 它 。	not a match

公元前8世紀，在邁錫尼文明衰亡之後，希臘逐漸從中世紀中嶄露頭角。	公元 前 8 世紀 ， 在 邁錫尼 文明 衰亡 之後 ， 希臘 逐漸 從 中 世紀 中 嶄露頭角 。		match

文明已經衰落，邁錫尼的文字也被遺忘，但希臘人沿用了腓尼基字母表，並以此為基礎發明了希臘字母表。	文明 已經 衰落 ， 邁錫尼 的 文字 也 被 遺忘 ， 但 希臘人 沿用 了 腓尼基 字母表 ， 並 以 此 為 基礎 發明 了 希臘 字母表 。	幸運 的 是 ， 當時 索尼 澳大利亞 有 人 覺得 " 嘿 ， 順便 說 一 下 ， 你們 注意 到 這 一 點 嗎 ？ " 鮑爾 說 。	not a match

從公元前9世紀，逐漸出現了第一批希臘文字。	從 公元 前 9 世紀 ， 逐漸 出現 了 第一 批 希臘 文字 。		match

很大程度上由於希臘的地理條件（幾乎每個島嶼、山谷和平原都被海洋或山脈於外界隔開了），希臘被分成了許多個小型自治城區。	很大 程度 上 由於 希臘 的 地理 條件 （ 幾乎 每個 島嶼 、 山谷 和 平原 都 被 海洋 或 山脈 於 外界 隔開 了 ） ， 希臘 被 分成 了 許多 個 小型 自治 城區 。	當 西格爾 描述 俄羅斯 在 克里米亞 （ 已 於 2014 年 被 吞併 ） 的 行動 時 ， 他 將 之 描述 為 “ 非常 合理 ” ， 因而 登上 了 新聞 頭條 。	not a match

從公元前8世紀開始，城邦制逐漸建立：即擁有自己的政治系統的小型自治領地制度。	從 公元 前 8 世紀 開始 ， 城邦制 逐漸 建立 ： 即 擁有 自己 的 政治 系統 的 小型 自治 領地 制度 。		match

在中世紀，大部分基督徒並沒有母語版的聖經。	在 中 世紀 ， 大部分 基督徒 並 有 母語版 的 聖經 。	一 位 狂熱 的 吉他手 ， 他 同年 在 那裡 舉辦 了 演唱會 。	not a match

但是，直到建造出能跨海的大船之前，他們並沒有擴張。	但是 ， 直到 建造 出 能 跨海 的 大船 之前 ， 他 並 有 擴張 。		match

通過在地中海地區遍布商業崗哨的方式建立起了商業來往，這種方法在此之前從未有人用過。	通過 在 地中海 地區 遍布 商業 崗哨 的 方式 建立 起 了 商業 來往 ， 這 種 方法 在 此 之前 從未 有 人 用 過 。	西格爾 的 祖母 來 自 俄羅斯 遠東 地區 的 符拉迪沃斯托克 ， 而 他 自己 近年 亦 經常 前往 俄羅斯 ， 並 在 九 月 訪問 了 堪察加 半島 和 庫頁島 。	not a match

這次事件可以被看作他激進革命事業的起點。	這 次 事件 可以 被 看作 他 激進 革命 事業 的 起點 。		match

在法國共和歷3年雨月（1794年1月至二月），為了緩解恐怖統治時期的壓力，他採取了多種方法來釋放嫌疑犯。	在 法國 共和歷 3 年 雨月 （ 1794 年 1 月 至 二 月 ） ， 為了 緩解 恐怖 統治 時期 的 壓力 ， 他 採取 了 多 種 方法 來 釋放 嫌疑犯 。	西格爾 提出 在 首都 貝爾格萊德 開辦 一 所 武術 學校 後 ， 於 今年 較早 時候 被 授予 塞爾維亞 國籍 。	not a match

由於資金全部來源於伯納德·塔比的個人財產，1994年他宣布破產後，這些學校就關閉了。	由於 資金 全部 來源 於 伯納德 · 塔比 的 個人 財產 ， 1994 年 他 宣布 破產 後 ， 這些 學校 就 關閉 了 。		match

儘管作為全球最大的設備和紡織品批發商，這個德國公司還是陷入了財政危機。	儘管 作 為 全球 最大 的 設備 和 紡織品 批發商 ， 這 個 德國 公司 還是 陷入 了 財政 危機 。	一 名 警方 發言人 告訴 美聯社 發生 了 “ 口角 ” 繼而 演變 為 “ 語言 衝突 ” ， 但 無 人員 傷亡 報告 。	not a match

為了徹底從中逃離，Remy一家1947年夏天大部分時間都居住在瑞士。	為了 徹底 從 中 逃離 ， Remy 一 家 1947 年 夏天 大部分 時間 都 居住 在 瑞士 。		match

在他們的回程上，他們抱著住在南美洲的想法，這樣能夠遠離比利時戰後的煩事。	在 他 的 回程 上 ， 他 抱 著 住 在 南 美洲 的 想法 ， 這樣 能夠 遠離 比利時 戰後 的 煩事 。	卡隆 的 上 一 部 影片 是 奧斯卡 獲獎 影片 “ 地心 引力 ” ， 據說 他 在 事故 發生 時 不 在 片場 。	not a match

在1948年春天，帶著能把丁丁歷險記拍成電影的希望，這位比利時藝術家給華特·迪士尼寫了封信，徒勞地尋求他的幫助。	在 1948 年 春天 ， 帶 著 能 把 丁丁 歷險記 拍成 電影 的 希望 ， 這 位 比利時 藝術家 給 華特 · 迪士尼 寫 了 封 信 ， 徒勞 地 尋求 他 的 幫助 。		match

夏天，Georges和他的妻子回到了瑞士，還帶著Germaine的一個朋友的18歲女兒Rosane。	夏天 ， Georges 和 他 的 妻子 回到 了 瑞士 ， 還 帶 著 Germaine 的 一 個 朋友 的 18 歲 女兒 Rosane 。	據 市 公安局 所 述 ， 週二 “ 一 大群 自稱 是 區 政府 機關 的 人 ” 來到 片場 後 發生 打鬥 。	not a match

假期期間，他和這個年輕的女孩子發展出了婚外情，之後不久他就承認了。	假期 期間 ， 他 和 這 個 年輕 的 女 孩子 發展 出 了 婚外情 ， 之後 不久 他 就 承認 了 。		match

在低處，有三棵棕櫚樹俯瞰大海，代表著島民對他們的小島的熱愛。	在 低處 ， 有 三 棵 棕櫚樹 俯瞰 大海 ， 代表 著 島民 對 他 的 小島 的 熱愛 。	研究 人員 付出 了 約 20 年 的 努力 研究 發展 男性 激素 避孕藥 的 潛力 。	not a match

另外，夏天島上有可能出現暴風雨。	另外 ， 夏天 島上 有 可能 出現 暴風雨 。		match

這些島嶼位於印澳板塊斷層上；板塊斷層是由於印度板塊和澳大利亞板塊碰撞導致的。	這些 島嶼 位 於 印 澳 板塊 斷層 上 ； 板塊 斷層 是 由於 印度 板塊 和 澳大利亞 板塊 碰撞 導致 的 。	他 補充 說 ： “ 這 是 在 尋找 男性 激素 避孕 方法 的 正確 組合 的 漫長 旅程 中 的 一 小步 。 ”	not a match

一項支持這個假設的證據是塞斯托聖喬瓦尼Villa Pelucca中的大量皇家馬匹。	一 項 支持 這 個 假設 的 證據 是 塞斯托聖喬瓦尼 Villa Pelucca 中 的 大量 皇家 馬匹 。		match

1928年，在公園東南部的賽道旁邊建了一座90公頃大的高爾夫球場。	1928 年 ， 在 公園 東南部 的 賽道 旁邊 建 了 一 座 90 公頃 大 的 高爾夫 球場 。	但是 也 有 很多 帶有 根深蒂固 的 宗教 信仰 的 MLA 反對 新 的 立法 。	not a match

1976年，賽馬場已經不再使用；1990年，一場大火吞噬了木製看台，其餘部分也在之後和馬厩一起被拆毀了。	1976 年 ， 賽馬場 已經 不 再 使用 ； 1990 年 ， 一 場 大火 吞噬 了 木製 看台 ， 其餘 部分 也 在 之後 和 馬厩 一起 被 拆毀 了 。		match

1969年8月，教皇保羅六世從梵蒂岡法律中移除了死刑，並將其從所有罪行中移除。	1969 年 8 月 ， 教皇 保羅 六世 從 梵蒂岡 法律 中 移除 了 死刑 ， 並 將 其 從 所有 罪行 中 移除 。	研究 人員 說 ， 分析 腫瘤 的 DNA 可能 有助 於 解釋 其他 癌症 的 成因 。	not a match

紀念幣本質上還是錢幣，但主要是為了銷售給收藏家的。	紀念幣 本質 上 是 錢幣 ， 但 主要 是 為了 銷售 給 收藏家 的 。		match

這個地區內部起伏突然，不同區域之間沒明顯的分隔。	這 個 地區 內部 起伏 突然 ， 不同 區域 之間 沒 明顯 的 分隔 。	該 分析 顯示 了 在 一 生 中 吸煙 的 總數 和 腫瘤 DNA 突變 的 數目 之間 的 直接 聯繫 。	not a match

這裡有許多史前手工加工品，包括一些不同的紀念碑和石製墓塚。	這裡 有 許多 史前 手工 加工品 ， 包括 一些 不同 的 紀念碑 和 石製 墓塚 。		match

接著建立了第二個阿普利亞和卡拉布里亞皇家區，同時也包括薩謨奈、部分莫利塞地區和巴西利卡塔東部。	接 著 建立 了 第二 個 阿普利亞 和 卡拉布里亞 皇家區 ， 同時 也 包括 薩謨奈 、 部分 莫利塞 地區 和 巴西利卡塔 東部 。	然而 ， 他 們 未 能 在 諸如 膀胱 的 組織 中 找到 相同 的 趨勢 ， 它 們 並 沒 有 直接 暴露 出 聯繫 。	not a match

13世紀期間，一些作家用阿普利亞來稱呼意大利半島南部。	13 世紀 期間 ， 一些 作家 用 阿普利亞 來 稱呼 意大利 半島 南部 。		match

歷史學家David Crouch建議Stephen放棄現在的挑戰轉而專心在其他事情上。	歷史學家 David Crouch 建議 Stephen 放棄 現在 的 挑戰 轉 而 專心 在 其他 事情 上 。	Pugh 女士 已經 在 劍橋 的 Papworth 和 Addenbrooke 醫院 接受 了 治療 。	not a match

亨利一世期間只有少數伯爵爵位存在，而且這些爵位具有很大的象徵意義。	亨利 一世 期間 只有 少數 伯爵 爵位 存在 ， 而且 這些 爵位 具有 很大 的 象徵 意義 。		match

法國大革命之後，在第一次反法同盟戰爭中，一位年輕的科西嘉砲兵軍官嶄露頭角，他就是拿破崙·波拿巴。	法國 大革命 之後 ， 在 第一 次 反 法 同盟 戰爭 中 ， 一 位 年輕 的 科西嘉 砲兵 軍官 嶄露頭角 ， 他 是 拿破崙 · 波拿巴 。	但 掃描 顯示 Pugh 女士 右肺 的 腫瘤 越來越 大 ， 因 此 她 要 離開 試驗 。	not a match

儘管並不能解決衝突，法國在馬倫哥戰役中的勝利迫使澳大利亞人第二次放棄了意大利。	儘管 並 能 解決 衝突 ， 法國 在 馬倫哥 戰役 中 的 勝利 迫使 澳大利亞人 第二 次 放棄 了 意大利 。		match

維勒訥沃艦隊的堵塞導致了侵略英倫三島的計劃，另一方面也是因為大陸出現了新的發展。	維勒訥沃 艦隊 的 堵塞 導致 了 侵略 英倫 三 島 的 計劃 ， 另 一 方面 是 因為 大陸 出現 了 新 的 發展 。	如果 唐納德 特朗普 成 為 總統 ， 這裡 的 政府 仍 將 要 與 他 一道 推進 任何 現有 的 共同 議程 ， 以 確保 可以 在 華盛頓 維護 加拿大 的 企業 和 利益 。	not a match

拿破崙確信，奧斯特利茨的成功能夠帶來一項全面的和平條約，但是他的希望很快就破滅了：新上任的英國首相格林威爾閣下拒絕所有協議，沙皇亞歷山大也一樣。	拿破崙 確信 ， 奧斯特利茨 的 成功 能夠 帶來 一 項 全面 的 和平 條約 ， 但是 他 的 希望 很快 就 破滅 了 ： 新 上任 的 英國 首相 格林威爾 閣下 拒絕 所有 協議 ， 沙皇 亞歷山大 也 一樣 。		match

關於宗教活動這方面，菲奧雷洛在英國聖公會內接受教育，並在餘生內都是新教的一員。	關於 宗教 活動 這 方面 ， 菲奧雷洛 在 英國 聖公會 內 接受 教育 ， 並 在 餘生 內 是 新教 的 一 員 。	特魯多 將 延長 對 美國 第45 任 總統 的 要求 ， 無論 總統 是 誰 。	not a match

那個男人告訴他，正如他和Walter預測的那樣，兩個宇宙之間的戰爭將要來臨；正因為如此，Olivia和其他人都是被當作孩子來受訓的。	那 個 男人 告訴 他 ， 正 如 他 和 Walter 預測 的 那樣 ， 兩 個 宇宙 之間 的 戰爭 將 要 來臨 ； 正 因為 如此 ， Olivia 和 其他 人 是 被 當作 孩子 來 受訓 的 。		match

Goffredo Petrassi的兩個學生、Ennio Morricone以及Bruno Nicolai在聖塞西莉亞音樂學校見面了。	Goffredo Petrassi 的 兩 個 學生 、 Ennio Morricone 以及 Bruno Nicolai 在 聖塞西莉亞 音樂 學校 見面 了 。	儘管 今天 上午 有 照片 發布 ， 但 B.C. 的 警方 表示 ， 他 們 對 這 個 顯然 無家可歸 而 被 控 致命 刺傷 阿伯茨福德 高中 的 年輕 女孩 的 人 有 疑問 多 於 答案 。	not a match

他們兩個之間形成了一種延續了多年的專業而友好的關係。	他 兩 個 之間 形成 了 一 種 延續 了 多 年 的 專業 而 友好 的 關係 。		match

Nicolai和藝名為Metti的Morricone在很多電影原聲上有所合作；有的作品是他們兩個人共同合作完成的。	Nicolai 和 藝名 為 Metti 的 Morricone 在 很多 電影 原聲 上 有 所 合作 ； 有的 作品 是 他 兩 個 人 共同 合作 完成 的 。	B.C. 警方 說 ， 早前 克萊恩 似乎 並 沒 有 犯罪 歷史 ， 並 發布 了 關於 他 最近 的 行踪 模糊 的 細節 。	not a match

但是，由於他們兩人之間非正式的合作導致的法律糾紛，兩人之間的友誼出現了破裂。	但是 ， 由於 他 兩 人 之間 非 正式 的 合作 導致 的 法律 糾紛 ， 兩 人 之間 的 友誼 出現 了 破裂 。		match

在他們多次的合作中，並不清楚到底是誰想出了一些風格上的管理解決方法，從而在之後塑造了兩位藝術家的風格。	在 他 多 次 的 合作 中 ， 並 不 清楚 到底 是 誰 想出 了 一些 風格 上 的 管理 解決 方法 ， 從而 在 之後 塑造 了 兩 位 藝術家 的 風格 。	我 們 不 認 為 嫌疑人 與 這 所 學校 丶 那 兩 名 女孩 或 更 確切 的 說 是 阿伯茲福德 地區 有 任何 联系 ， 她 說 。	not a match

20世紀中，1904年到1914年之間，安東尼奧·高迪帶來了一場持續了十年的改革。	20 世紀 中 ， 1904 年 到 1914 年 之間 ， 安東尼奧 · 高迪 帶來 了 一 場 持續 了 十 年 的 改革 。		match

在後殿有三個平行的小教堂，拱璧之間有許多橫向的小教堂。	在 後殿 有 三 個 平行 的 小教堂 ， 拱璧 之間 有 許多 橫向 的 小教堂 。	他 還 表示 ， 克萊恩 沉默寡言 ， 不 合作 且 不 情願 走出 牢房 出席 法院 的 聽證會 。	not a match

傳統是要選出一個主題來，因為住在帕爾馬的皈依猶太教的人數眾多。	傳統 是 要 選出 一 個 主題 來 ， 因為 住 在 帕爾馬 的 皈依 猶太教 的 人數 眾多 。		match

在安第斯山脈形成之前，南美洲西部邊緣已經發生過好幾次造山運動。	在 安第斯 山脈 形成 之前 ， 南 美洲 西部 邊緣 已經 發生 過 好幾 次 造山 運動 。	代表 安大略省 的 房地產 經紀人 協會 表示 ， 還 需要 做 更多 的 工作 來 保障 消費者 並 懲罰 參與 不 道德 行為 的 代理商 。	not a match

安第斯山脈中心屬於被稱作“Andes de tipo andino”的地區，該地區是由於海洋地殼潛沒形成的。	安第斯 山脈 中心 屬 於 被 稱作 “ Andes de tipo andino ” 的 地區 ， 該 地區 是 由於 海洋 地殼 潛沒 形成 的 。		match

但是，他和利納雷斯關係的破裂以及革新的停滯不前導致了1879年推翻他的維和革命。	但是 ， 他 和 利納雷斯 關係 的 破裂 以及 革新 的 停滯 不前 導致 了 1879 年 推翻 他 的 維和 革命 。	他 還 希望 給予 負責 管理 省內 代理人 的 安大略省 的 房地產 理事會 （ RECO ） 具有 更大 的 執法 和 調查 權力 。	not a match

在他的管理下，女性獲得了投票權，政治黨派得到了合法化，被流放的人得以歸家，政治迫害犯也被釋放了。	在 他 的 管理 下 ， 女性 獲得 了 投票權 ， 政治 黨派 得到 了 合法化 ， 被 流放 的 人 得 以 歸家 ， 政治 迫害犯 也 被 釋放 了 。		match

幾十家銀行的破產和乾預導致資本外流，造成許多家企業破產。	幾十 家 銀行 的 破產 和 乾預 導致 資本 外流 ， 造成 許多 家 企業 破產 。	目前 ， RECO 可以 向 代理 徵收 的 最高 罰款 是 $25,000 。	not a match

它是從第二邊界到外邊界之間的部分，想像中的那條線鏈接著埃斯特角的地標燈塔和Punta Rasa的地標燈塔。	它 是 從 第二 邊界 到 外邊界 之間 的 部分 ， 想像 中 的 那 條 線 鏈接 著 埃斯特角 的 地標 燈塔 和 Punta Rasa 的 地標 燈塔 。		match

在1777年十月，當約翰·伯戈因將軍指揮的英國軍隊在紐約州北部的薩拉託加投降時，事情就已經開始發生變化了。	在 1777 年 十 月 ， 當 約翰 · 伯戈因 將軍 指揮 的 英國 軍隊 在 紐約州 北部 的 薩拉託加 投降 時 ， 事情 就 已經 開始 發生 變化 了 。	但是 中國 日益 壯大 的 中產 階級 已經 發出 了 非同尋常 的 呼聲 ， 控訴 諸如 北京 的 大城市 中 的 有毒 空氣 ， 這些 嗆肺 的 霧霾 日 復 一 日 ， 顯而易見 。	not a match

為了獲得獨立，致命的一擊和適當的鼓勵正是移民者所需要的。	為了 獲得 獨立 ， 致命 的 一 擊 和 適當 的 鼓勵 是 移民者 所 需要 的 。		match

Joseph Brant帶領的來自加拿大的印第安人到達了；殖民者徵收了越來越多的屬於他們的土地，所以他們趕來支持英國人。	Joseph Brant 帶領 的 來 自 加拿大 的 印第安人 到達 了 ； 殖民者 徵收 了 越來越 多 的 屬 於 他 的 土地 ， 所以 他 趕來 支持 英國人 。	我 們 看到 很多 很多 國家 ， 特別 是 像 巴西 丶 南非 丶 印度 和 中國 等 大型 新興 排放 國家 ， 逐漸 擔負 起 了 減少 溫室 氣體 排放 中 的 責任 ， Guilbeault 說 。	not a match

約翰·伯戈因將軍領導了這次遠征，他希望能到達奧爾巴尼。	約翰 · 伯戈因 將軍 領導 了 這 次 遠征 ， 他 希望 能 到達 奧爾巴尼 。		match

但是，他們被攔截了，所以不得不在哈德遜河附近的Freeman進行戰鬥。	但是 ， 他 被 攔截 了 ， 所以 得 不 在 哈德遜河 附近 的 Freeman 進行 戰鬥 。	他 也 可以 等到 他 的 第一 個 任期 結束 時 ， 運用 巴黎 協定 中 的 條款 退出 協議 。	not a match

黃金時代的西班牙語和早期現代西班牙語是從中世紀西班牙語向現代西班牙語轉型的變種語言。	黃金 時代 的 西班牙語 和 早期 現代 西班牙語 是 從 中 世紀 西班牙語 向 現代 西班牙語 轉型 的 變種 語言 。		match

另一方面，外部的歷史包括西班牙語使用者的歷史、他們的歷史變遷和復興以及西班牙語的社會運用。	另 一 方面 ， 外部 的 歷史 包括 西班牙語 使用者 的 歷史 、 他 的 歷史 變遷 和 復興 以及 西班牙語 的 社會 運用 。	與 此 同時 ， 克林頓 和 盟友們 正 努力 讓 特朗普 立 於 聚光燈 下 ， 指責 他 蔑視 女性 和 少數 族裔 ， 且 他 的 性情 使 他 無法 勝任 。	not a match

但是，如果英國法被接受的話，路易十世、菲利普五世、卡洛斯四世的女兒們的繼承順位，就比她們的姨媽法蘭西的伊莎貝拉的更靠前了。	但是 ， 如果 英國法 被 接受 的話 ， 路易 十世 、 菲利普 五世 、 卡洛斯 四世 的 女兒們 的 繼承 順位 ， 就 比 她 的 姨媽 法蘭西 的 伊莎貝拉 的 更 靠前 了 。		match

追求和平的嘗試在1415年春天告終，安立奎決定實施他的計劃：侵略整個法國。	追求 和平 的 嘗試 在 1415 年 春天 告終 ， 安立奎 決定 實施 他 的 計劃 ： 侵略 整個 法國 。	這 不 是 我 們 的 國家 所需 要 的 ， 兄弟們 。	not a match

他也討論了布宜諾斯艾利斯的聯邦化、商業條約的延續以及任命軍隊的新將軍的事宜。	他 也 討論 了 布宜諾斯艾利斯 的 聯邦化 、 商業 條約 的 延續 以及 任命 軍隊 的 新將軍 的 事宜 。		match

1976年，他碰到了他的一位朋友，Kiki Dee，她和火箭唱片公司正在合作，也正是這家公司發行了他另一首極為成功的歌曲：《勿傷我心》。	1976 年 ， 他 碰到 了 他 的 一 位 朋友 ， Kiki Dee ， 她 和 火箭 唱片 公司 正 在 合作 ， 也 是 這 家 公司 發行 了 他 另 一 首 極為 成功 的 歌曲 ： 《 勿 傷 我 心 》 。	特朗普 的 妻子 梅拉尼亞 特朗普 ， 自 七 月 的 共和黨 全國 代表 大會 以來 首次 亮相 於 活動 中 。	not a match

龐培取得了兩支在卡普亞的軍隊的指揮權，並開始進行非法徵兵，這是一個預料之中的行為，但依然從向著他的凱撒軍那裡佔了不少便宜。	龐培 取得 了 兩 支 在 卡普亞 的 軍隊 的 指揮權 ， 並 開始 進行 非法 徵兵 ， 這 是 一 個 預料 之中 的 行為 ， 但 依然 從 向 著 他 的 凱撒軍 那裡 佔 了 不少 便宜 。		match

那時已經結束了自己的政期的Curio親自將龐培的行動告訴了凱撒。	那 時 已經 結束 了 自己 的 政期 的 Curio 親自 將 龐培 的 行動 告訴 了 凱撒 。	像 Rai 一樣 的 學生 已經 在 學校 與 輔導員 會面 ， 談論 發生 了 什麼 事 ， 但 她 說 ， 最大 安慰 是 可以 見到 她 的 朋友們 。	not a match

與此同時，他保民官的職位也被馬克·安東尼霸占，他霸占此職位直到12月。	與 此 同時 ， 他 保民官 的 職位 也 被 馬克 · 安東尼 霸占 ， 他 霸占 此 職位 直到 12 月 。		match

但是，當參議院確鑿無疑地回答了他，禁止他參加領事的角逐，並讓他選擇要么撤回軍隊要么成為人民共同的敵人時，他就明白了不管他怎麼選擇，他都將手無寸鐵地向自己的政治敵人投降。	但是 ， 當 參議院 確鑿 無疑 地 回答 了 他 ， 禁止 他 參加 領事 的 角逐 ， 並 讓 他 選擇 要么 撤回 軍隊 要么 成 為 人民 共同 的 敵人 時 ， 他 就 明白 了 不管 他 怎麼 選擇 ， 他 都 將 手無寸鐵 地 向 自己 的 政治 敵人 投降 。	這 對 受 疼痛 折磨 的 病人 來 說 是 一 場 災難 ， Mailis 在 周 四 接受 採訪 時 對 CBC 新聞 說 。	not a match

公元前49年1月1日，馬克·安東尼宣布了一封來自凱撒的宣言，其中表示地方總督宣布和他建立和平的友誼關係。	公元 前 49 年 1 月 1 日 ， 馬克 · 安東尼 宣布 了 一 封 來 自 凱撒 的 宣言 ， 其中 表示 地方 總督 宣布 和 他 建立 和平 的 友誼 關係 。		match

percentage correct: 0.50 percent
